11111111111111111111
1C000000010000000001
1011000P010000111101
1001000C011100100101
10010000000000100101
11110000000000100001
1000000C100111101111
11111010100100000001
10000010111100000101
100000100001000001E1
11111111111111111111